0,0,0,1,1,1,1,1,0,0,0;
0,0,0,1,1,1,1,1,0,0,0;
0,0,0,1,1,1,1,1,0,0,0;
0,0,0,1,1,1,1,1,0,0,0;
0,0,0,1,1,1,1,1,0,0,0;
0,0,0,1,1,1,1,1,0,0,0;
0,0,0,1,1,1,1,1,0,0,0;
0,0,0,1.1,1,1,1,1.1,0,0,0;
0,0,0,0,1.3,1,1,0,0,0,0;
0,0,0,1,1,1,1,1,0,0,0;
0,1,1,1,1,6,1,1,1,1,0;
1,2,1,1,1,1,1,1,1,1,1;
1,1,1,1,0,0,0,1,1,1,1;
1,1,2,0,0,0,0,1,1,2,0;
1,0,0,0,0,0,0,0,2,1,0;
3,0,0,0,0,0,0,0,1,1,1;
1,0,0,0,0,0,0,0,1.1,1,1.3;
1,0,0,0,0,0,0,0,0,1,1;
1,1,0,0,0,0,0,0,0,2,2;
0,2,1,0,0,0,0,0,0,1,1;
0,2,1,0,0,0,0,0,0,1,1;
0,0,1,1,0,0,0,0,0,1,1;
0,0,1,1,0,0,0,0,0,1,1;
0,0,0,1,1,0,0,0,0,1.1,1;
0,0,0,0,1,1,0,0,0,0,1;
0,0,0,0,0,1,0,0,0,0,1;
0,0,0,0,0,1,0,0,0,0,1;
0,0,0,0,0,3,0,0,0,1.1,1;
0,0,0,0,1,1,0,0,0,1.1,1;
0,0,0,1,1,1,0,0,0,0,1;
0,0,1,1,1,0,0,0,0,0,1;
0,1,1,1,0,0,0,0,0,0,1;
1.1,1,1,0,0,0,0,0,0,0,1;
1.1,2,1,0,0,0,0,0,0,0,1;
1.1,1,1,0,0,0,0,0,0,0,1;
1.1,1,1,0,0,0,0,0,0,0,1;
0,1,1,1,0,0,0,0,0,1,1;
0,0,1,2,1,0,0,0,1,1,2;
0,0,0,1,1,1,0,1,1,1,0;
0,0,0,0,1,1,1,1,1,0,0;
0,0,0,0,1,4,1,1,1,0,0;
0,0,0,0,1,1,1,1,1.1,0,0;
0,0,0,0,1,1.3,1.3,1,1,0,0;
0,0,0,0,0,1,1,1,0,0,0;
0,0,0,0,0,1,1,1,0,0,0;
0,0,0,0,0,0,5,0,0,0,0;
0,0,0,0,0,0,0,0,0,0,0;
0,0,0,0,0,0,1,0,0,0,0;
0,0,0,0,0,0,5,0,0,0,0;
0,0,0,0,0,0,0,0,0,0,0;
0,0,0,0,0,0,1,0,0,0,0;
0,0,0,0,0,0,5,0,0,0,0;
0,0,0,0,0,0,0,0,0,0,0;
0,0,0,0,0,0,1,0,0,0,0;
0,0,0,0,0,0,5,0,0,0,0;
0,0,0,0,0,0,0,0,0,0,0;
0,0,0,0,0,1,2,1,0,0,0;
0,0,0,0,0,1,1,3,0,0,0;
0,0,0,1,0,1,1,1,0,1,0;
0,0,0,0,0,1,1,1,0,0,0;
0,0,0,0,0,1,1,1,0,0,0;
0,0,0,0,0,1,1,1,0,0,0;
0,0,0,1,0,1,4,1,0,1,0;
0,0,0,0,0,1,1,1,0,0,0;
0,0,0,0,0,1,2,1,0,0,0;
0,0,0,0,0,1,1,1,0,0,0;
0,0,0,1,0,2,2,1,0,0,0;
0,0,0,0,0,1,1,1,0,0,0;
0,0,0,0,0,1,1,1,0,0,0;
0,0,0,0,0,1,3,1,0,0,0;
0,0,0,1,0,1,1,1,0,1,0;
0,0,0,0,0,5,5,5,0,0,0;
0,0,0,0,0,0,0,0,0,0,0;
0,0,0,0,0,1,1.1,1,0,0,0;
0,0,0,0,0,1,1.1,1,0,0,0;
0,0,0,0,0,5,3,5,0,0,0;
0,0,0,0,0,0,0,0,0,0,0;
0,0,0,0,0,1,0,1,0,0,0;
0,0,0,0,0,1,0,1,0,0,0;
0,0,0,0,0,5,0,5,0,0,0;
0,0,0,0,0,0,0,0,0,0,0;
0,0,0,0,1,1,0,1,1,0,0;
0,0,0,1,1,1,0,6,1,1,0;
0,0,1,2,1,5,0,1,1,1,1.1;
0,0,1,4,1,0,0,0,1,2,1.1;
0,0,1,1,1,1,0,1,1,1.3,1.1;
0,0,0,1,1,1,0,1,1,1,0;
0,0,0,0,1,5,0,5,1,0,0;
0,0,0,0,0,0,0,0,0,0,0;
0,0,0,0,0,0,2,0,0,0,0;
0,0,0,0,0,0,1,0,0,0,0;
0,0,0,0,0,0,1,0,0,0,0;
0,0,0,0,0,0,1,0,0,0,0;
0,0,0,0,0,0,1,0,0,0,0;
0,0,0,0,0,0,2,0,0,0,0;
0,0,0,0,0,0,5,0,0,0,0;
0,0,0,0,0,0,0,0,0,0,0;
0,0,0,0,0,3,4,3,0,0,0;
0,0,0,0,1,1,1,1,1,0,0;
0,0,0,0,1,1,1,1,1,0,0;
0,0,1,1,1,0,1.3,1,1,1,1;
0,0,2,2,2,0,2,2,0,0,2;
0,0,1,1,1,0,1,1,0,0,1;
0,0,1,1,4,1,1,1,3,1,1;
0,0,0,0,0,3,0,0,1,1,1;
0,0,1,1.3,1,1,0,1,1,1,0;
0,0,3,1,1,1,1,1,1,1,3;
0,0,1,1,1,1,1,1,1,1,1;
0,0,2,0,0,1,1,1,0,0,2;
0,0,1,1,0,0,2,2,0,0,1;
0,0,1.3,1,0,0,2,2,0,0,1;
0,0,1,1,1,5,1,1,3,1,1;
0,0,1,0,0,0,0,0,1,1,1;
0,0,1,0,0,0,0,0,1,1,1;
0,0,1,1.3,1,1,1,1,1,1,0;
0,0,0,0,1,1,1,1,1,0,0;
0,0,0,0,0,4,2,0,0,0,0;
0,0,0,0,0,1,1,1,0,0,0;
0,0,0,0,1,2,2,2,0,0,0;
0,0,0,1.3,1,1.3,1,0,0,0,0;
0,0,0,1.1,1,1,0,0,0,0,0;
0,0,0,1,1,1,0,0,0,0,0;
0,0,0,1,1.1,1,0,0,0,0,0;
0,0,0,1,1,1,0,0,0,0,0;
0,0,0,1.1,1,1,0,0,0,0,0;
0,0,0,0,1,1,1,0,0,0,0;
0,0,0,0,7,7,7,0,0,0,0;
0,0,0,0,7,7,7,0,0,0,0;
0,0,0,0,7,7,7,0,0,0,0;