0,0,0,1,1,1,1,1,1,0,0;
0,0,0,1,1,1,1,1,1,0,0;
0,0,0,1,1,1,1,1,1,0,0;
0,0,0,1,1,1,1,1,1,0,0;
0,0,0,1,1,1,1,1,1,0,0;
0,0,0,1,1,1,1,1,1,0,0;
0,0,0,1,1,1,1,1,1,0,0;
0,0,0,1.1,1,1,1,1,1.1,0,0;
0,0,0,1.3,1.1,1,1,1.1,1.3,0,0;
0,0,0,0,0,1,1,0,0,0,0;
0,0,0,0,0,3,1,0,0,0,0;
0,0,0,1.4,0,1,1,0,1.1,0,0;
0,0,0,0,0,4,1,0,0,0,0;
0,0,0,0,0,1,1,0,0,0,0;
0,0,0,0,0,1,3,0,0,0,0;
0,0,0,1.4,0,1,1,0,1.3,0,0;
0,0,0,0,0,1,4,0,0,0,0;
0,0,0,0,0,1,1,0,0,0,0;
0,0,0,0,0,3,1,0,0,0,0;
0,0,0,1.4,0,1,1,0,1.1,0,0;
0,0,0,0,0,4,1,0,0,0,0;
0,0,0,0,0,1,1,0,0,0,0;
0,0,0,0,0,1,1,0,0,0,0;
0,0,0,0,1.1,1,1,1.1,0,0,0;
0,0,0,1.1,1,1,1,1,1.1,0,0;
0,0,1.1,1,1,1,1,1,1,1.1,0;
0,0,1.1,1,1,1,1,1,1,1.1,0;
0,0,1.1,1,1,1,1,1,1,1.1,0;
0,1.1,1,1,5,0,0,5,1,1,1.1;
0,1,1,1,0,0,0,0,1,1,1;
0,1,1,0,0,1.1,1,0,0,1,1;
0,1,1,0,0,1,1,0,0,1.1,1;
0,1.3,5,0,0,5,5,0,0,1,1;
0,1,1,0,0,0,0,0,0,1,1;
0,1,1.1,0,0,1,1,0,0,1,1;
0,1,1,0,0,1,1.3,0,0,1,1;
0,5,1,0,0,5,5,0,0,1.3,1;
0,1,1,0,0,0,0,0,0,1,1;
0,1,1,0,0,1,4,0,0,1,1.1;
0,1,1,0,0,5,5,0,0,1,1;
0,1,1,1,0,0,0,0,1,1,1;
0,1.1,1,1,1,0,0,1,1,1,1.1;
0,0,1.1,1,1,1,1,1,1,1.1,0;
0,0,0,1.1,1,1,1,1,1.1,0,0;
0,0,0,0,2,2,2,2,0,0,0;
0,0,0,0,0,1,1,0,0,0,0;
0,0,0,0,0,2,2,0,0,0,0;
0,0,0,0,0,1,1.3,0,0,0,0;
0,0,0,0,2,2,2,2,0,0,0;
0,0,0,0,1,1,1,1,0,0,0;
0,0,0,0,0,0,1,1,0,0,0;
0,0,0,0,0,1.1,1,1,1.1,0,0;
0,0,0,0,0,1.1,1,1,1,1.1,0;
0,0,0,0,0,0,1,1,1,1,0;
0,0,0,0,0,1,1,1,0,0,0;
0,0,0,0,1,1,1,1,1,1.1,0;
0,0,0,1.1,1,1,1,1,1.1,0,0;
0,0,0,1.1,1,1,1,1,0,0,0;
0,0,0,1,1,1,1.3,1,0,0,0;
0,0,0,1,3,1,1,4,1,0,0;
0,0,0,1,1,1,0,0,1,0,0;
0,0,0,0,1,1,0,0,1,0,0;
0,0,0,0,0,1,0,0,1,0,0;
0,0,0,0,0,1,1,1,1,0,0;
0,0,0,0,0,1,1,1,1,0,0;
0,0,0,1.4,1,1,1,1,1,0,0;
0,0,0,1,1,1,1,1,1.1,0,0;
0,0,0,1,1,1,1,1.1,0,0,0;
0,1.1,1,1,1,1,1,1.1,0,0,0;
0,1,1.1,1,6,6,0,0,0,0,0;
0,0,0,1,1,1,0,0,0,0,0;
0,0,0,1,1,1,0,0,0,0,0;
0,0,0,5,5,5,0,0,0,0,0;
0,0,0,0,0,0,0,0,0,0,0;
0,0,0,1,1,1,0,0,0,0,0;
0,0,0,5,5,5,0,0,0,0,0;
0,0,0,0,0,0,0,0,0,0,0;
0,1,1,1,0,6,6,6,0,0,0;
0,1,4,1,0,1,1,1,0,0,0;
0,5,5,5,0,5,5,5,0,0,0;
0,0,0,0,0,0,0,0,0,0,0;
1,4,0,0,0,0,0,0,1,1,0;
5,5,0,0,0,0,0,0,5,5,0;
0,0,0,0,0,0,0,0,0,0,0;
1.3,1,0,0,0,0,0,0,1,1.3,0;
1,1,0,0,0,0,0,0,1,1,1;
1,4,0,1.3,0,0,0,0,0,1,1;
1,1.3,0,0,0,1.4,0,0,0,0,1;
1,1,0,0,0,0,0,0,0,1,1;
0,1,0,1.1,0,0,0,0,1,1,1;
0,1,0,0,0,0,0,0,1,1,0;
1,1,0,0,0,0,0,0,1,0,0;
4,1,0,1.1,0,1.4,0,0,1,0,0;
1,0,0,0,0,0,0,0,1,1,0;
1,0,0,0,0,0,0,0,1,1,0;
1,0,0,1.3,0,1.4,0,0,0,1,0;
1,1,0,0,0,0,0,0,0,1,0;
1,1,0,0,0,0,0,0,1,1,0;
1,1,0,1,0,0,1,0,1,1,0;
5,5,0,0,0,0,0,0,5,0,0;
0,0,0,0,0,0,0,0,0,0,0;
1,1,0,0,0,0,0,0,1,1,0;
1,1,0,0,0,0,0,0,1,1,0;
5,5,0,0,0,0,0,0,5,5,0;
0,0,0,0,0,0,0,0,0,0,0;
0,1,1,1,0,0,1,1,1,0,0;
0,1,1,1,0,0,1,1,1,0,0;
0,1,5,5,0,0,5,5,1,0,0;
0,0,0,0,0,0,0,0,0,0,0;
0,0,1,1.3,1.1,1.1,1,1,0,0,0;
0,0,1,1,1,1.1,1,1,0,0,0;
0,0,0,1,1,1,1,1,0,0,0;
0,0,0,0,7,7,7,0,0,0,0;
0,0,0,0,7,7,7,0,0,0,0;
0,0,0,0,7,7,7,0,0,0,0;